1,1,1,1,1,1,1,1,1,1
1,0,8,8,0,0,8,8,10,1
1,0,8,8,0,6,8,8,0,1
1,0,9,0,8,7,0,0,0,1
1,0,0,8,8,4,0,0,0,1
1,0,8,5,0,0,11,8,0,1
1,5,8,8,0,0,8,8,0,1
1,1,1,1,1,1,1,1,1,1
